NO ./img/default/bloody_wall_01.png



SO ./img/default/brick.png



WE ./img/default/brown_wall.png


EA ./img/default/brown_wall_light_cropped.png

F 0,0,255
C 255,0,0

111111
1S0101
101001
100001
111111
