NO./textures/diamond.png



SO./textures/wood.png



WE ./textures/stone.png


EA./textures/gold.png

F 255,0,0
C 0,255,0

11111111
10100001
10100E01
10100001
10000001
10000101
10000001
11111111