
NO ./img/default/bloody_wall_01.png
SO ./img/default/bloody_wall_02.png
WE ./img/default/brown_wall.png
EA ./img/default/brown_wall_light_cropped.png

F 128,128,128
C 255,255,255

11111111111111111
10000000000000001
100000000000000N1
10000000111111111
100000001
100000001
111111111
