
NO ./img/default/bloody_wall_01.png
SO ./img/default/bloody_wall_02.png
WE ./img/default/brown_wall.png
EA ./img/default/brown_wall_light_cropped.png

F 128,128,128
C 255,255,255

11111111111111111111111111111111
10000000000000000000010000000001
11111111111111111111010000000001
                   1010000000001
 11111111111111111 1010000000001
 10000000000000001 1010000000001
 10111111111111101 1010000000001
 101           101 1010000000001
 101 111111111 101 1010000000001
 101 100000001 101 1010000000001
 101 101111101 101 1010000000001
 101 101   101 101 1010000000001
 101 101   101 101 1010000000001
 101 101   101 101 1010000000001
 101 101   101 101 1010000000001
 101 101   111 101 1010000000001
 101 101       101 1010000000001
 101 1011111111101 1010000000001
 101 1000000000001 1010000000001
 101 1111111111111 1010000000001
 101               1010000000001
11011111111111111111011111111001
10000000000000000000010000000001
11110000111111111111110000000001
10000000000000000000000000000001
100000000000000000000000000000N1
11111111111111111111111111111111
