

NO ./img/text_NO.png
SO ./img/text_SO.png
WE ./img/text_WE.png
EA ./img/text_EA.png
F 128,128,128
C 255,255,255


    1
111101
   100111
111001
   1S011
111001
1011111111111111111111111111
 10101                              11
 1010111111111111111111111       111  1
  111                               11
