
NO ./img/default/bloody_wall_01.png
SO./img/default/bloody_wall_02.png
WE./img/default/brown_wall.png
EA ./img/default/brown_wall_light_cropped.png
F 255,0,0
C 135,206,235


11111111111111111
10000000010N000001
100000000000000001
11111111111111111
