
NO ./img/default/bloody_wall_01.png
SO./img/default/bloody_wall_02.png
WE./img/default/brown_wall.png
EA ./img/default/brick.png
F 255,0,0
C 135,206,235


111111111111111111
100000000010000001
100000000000000011
100000000000000011
100000000000000011
111111111111111111
100000000000000W1
111111111111111111
100000000000000011
100000000000000011
100011111110100001
111111111111111111
1111111111111
             111
            1111111111
1111111111111
